11111111111111111111111111
10000000000000000000000001
10000000000000000000000001
1000000C000000000000000001
10000000000000000000000001
10000000000000000000000001
100000C000000000000C000001
10000000000000000000000001
1000000000P00000C000000001
100000C0000000000000000001
1000000000000C000000000001
10000000000000000000000001
11111111111111111111111111